Flags Time
1
You have to collect all flags !
19 3 19 40
2 2 9 18 2
1 0 0 0 null
ЭЭЭЭЭЭЭЭЭЭЭЭЭЭЭЭЭЭЭЭЭЭЭЭЭЭЭЭЭЭЭЭЭЭЭЭЭЭЭЭЭ
ББББББББББББББББББББББББББББББББББББББББ
Б   Б       ББъъъъъъъъББББ           ББ
Б Б Б БББББ ББББББББББББББ БББББББББББББ
Б Б   Б   Б Б          БББ Б   Б   Б   Б
Б БББББ Б Б   ББББ БББ  ББ Б Б Б Б Б Б Б
Б     Б Б БББББ      ББ ББ Б Б Б Б Б ББ
Б БББ Б Б    Б  ББББ  Б ББ Б Б Б Б Б БББ
Б БББ Б ББББ Б ББъъББ Б ББ Б Б   Б   Б Б
Б   Б             ъББ Б ББ Б БББББББ Б Б
БББББББ Б ББББ ББъъББ Б Б Б БББББ Б   Б
Б    Б Б Б     ББББ  Б ББ Б Б   Б Б Б Б
Б БББББ Б Б БББ      ББ ББ Б Б Б Б   Б Б
Б БББББ Б Б ББББББББББ  ББ Б БББ БББББ Б
Б Б     Б              БББ Б           Б
Б   Б БББББББББ БББББ ББББ Б БББ БББББ Б
ББ ББ     БББ   БББББ      Б Б   Б     Б
ББ ББББ Б   Б Б ББББББББББББ БББББ БББББ
Б      БББ   Б              Б     БББ
ББББББББББББББББББББББББББББББББББББББББ