Night Cliffs
2
Now the centaur had anticipated !
Try to go at final now !
19 3 19 40
2 2 9 26 0
1 0 0 0 null
ΝΝΝΝΝΝΝΝΝΝΝΝΝΝΝΝΝΝΝΝΝΝΝΝΝΝΝΝΝΝΝΝΝΝΝΝΝΝΝΝΝ
±±±±±±±±±±±±±±±±±±±±±±±±±±±±±±±±±±±±±±±±
±           ±                ±        ±
± ±±±±±±± ± ± ± ±±±±±±±±±±±±   ±±±±±±±±±
± ±      ± ± ±           ±± ±         ±
± ±±±±±±±±± ± ±±±±±±±±±±± ±± ±±±±±±±±± ±
±        ±±   ±±±±±± ±±±± ±± ±         ±
± ±±±±±±±±±±±±±κκκ±±         ± ±±±±±±±±±
±            ±κκκκκ± ±±±±±±±±± ±   ±   ±
±±±±±±±± ± ± ±κκκκκ± ±±±  ±±± ± ± ± ± ±
±±±      ± ± ±κκκκκ±           ± ± ± ± ±
±   ±±±±±± ± ±±±±±±± ±±± ±±±±±±± ± ± ± ±
± ±±±      ±       ± ± ±   ±±    ±   ± ±
±     ±±±±±± ± ±±± ±   ±±± ±± ±±±±±±±± ±
± ±±±±±      ±   ± ± ±±±±±    ±±κκκ±±± ±
± ±    ±±±±±± ± ± ± ±   ±±±± ±κκκκκ±± ±
± ±±±±±±±   ±  ± ± ±   ±    ± ±κκκκκ±± ±
± ±   ±   ± ± ±± ± ± ±±±±±± ± ±κκκκκ±± ±
±   ±   ±     ±±     ±       ±±κκκ±± ±
±±±±±±±±±±±±±±±±±±±±±±±±±±±±±±±±±±±±±±±±
stage5.map