The begging
5
This is the centaur's maze!
It only can hear you !
You have to find the exit
whitout it catch you !
Good luck !
19 5 15 40
2 2 14 3 0
1 0 0 0 null
ЭЭЭЭЭЭЭЭЭЭЭЭЭЭЭЭЭЭЭЭЭЭЭЭЭЭЭЭЭЭЭЭЭЭЭЭЭЭЭЭЭ
ББББББББББББББББББББББББББББББББББББББББ
Б   Б     Б   Б             Б   Б   Б Б
Б Б   Б Б Б Б БББ Б ББББББ Б Б Б Б Б ББ
ББББББ Б Б Б ББББ Б      Б   Б Б Б Б ББ
Б Б     Б   Б      ББББББ БББББ   Б   ББ
Б ББББ БББББББ ББББББъъББ Б     БББ ББББ
Б    Б Б       Б   БъъъъБ ББББББББ     Б
ББББ Б Б Б БББББ Б БъъъъБ ББ     Б БББББ
Б  Б   Б Б     Б Б ББъъББ    Б Б Б  ББББ
Б ББББ Б БББББ Б Б  ББББББББ БББ ББ ББББ
Б      Б    ББ Б ББ Б     Б   Б   Б ББББ
ББББ БББББББББ Б Б    БББ Б Б Б Б Б    Б
ББ        ББББ Б Б БББББ Б Б Б Б Б ББ Б
Б ББББББ        Б      Б   Б   Б   Б Б
ББББББББББББББББББББББББББББББББББББББББ