Batman's cave
1
The centaur again, but now the maze is bigger !
4 3 19 70
10 34 2 2 4
1 0 0 0 null
ЭЭЭЭЭЭЭЭЭЭЭЭЭЭЭЭЭЭЭЭЭЭЭЭЭЭЭЭЭЭЭЭЭЭЭЭЭЭЭЭЭЭЭЭЭЭЭЭЭЭЭЭЭЭЭЭЭЭЭЭЭЭЭЭЭЭЭЭЭЭЭ
ББББББББББББББББББББББББББББББББББББББББББББББББББББББББББББББББББББББ
Б    Б   Б      Б   Б   Б   Б       ББ           Б   Б   Б   Б  Б Б
Б ББ Б Б Б Б ББ   Б Б Б Б Б Б БББББ Б Б БББББББББ Б Б Б Б Б Б БББ   ББ
Б Б   Б   Б  БББББ Б Б Б Б   Б   Б   Б         Б Б Б Б Б   Б Б   Б  Б
Б БББББББББББ    Б   Б   БББББ Б Б Б БББББББББ Б Б Б Б БББББ Б БББ ББ
Б   Б   Б   БББ БББББ БББ  Б    Б   ББ         Б   Б   Б       Б   Б
БББ Б Б   Б   Б Б   Б   ББ Б ББББББББББ Б Б БББББББББББББ БББББББББ ББ
Б   Б ББ ББББ Б Б Б БББ Б  Б     Б      Б Б Б             Б          Б
Б БББ Б Б Б  Б   Б     Б ББББББ Б ББББББ Б Б Б Б БББББББББ ББББББББ Б
Б     ББББ   ББББББББ БББ ББ ББ   Б      Б   Б   Б         Б        Б
БББББ Б    Б Б          Б      Б Б Б ББББББ БББ БББ БББББББББ ББББББББ
Б       ББ Б БББ Б ББББ ББББ БББ Б   Б  ББ ББ  ББ        ъБ        Б
Б БББББББ  Б     Б  Б       Б   Б БББББ       БББББББББББ БББББББББ Б
Б   Б     ББ ББ БББ ББББББББББ БББ   Б   БББББББ         Б Б         Б
Б БББ БББ ББББ    Б Б   Б    Б Б   Б   Б         БББББББ     БББББББББ
Б Б   ББ    ББББББ Б Б   Б    Б Б ББББББББББ ББББ    БББББББ       Б
Б Б БББ ББББ Б Б ББ Б ББ ББ ББББ Б Б   Б   ББ ББББ БББ Б       БББББ Б
Б         Б     Б    Б  Б      Б   Б   Б               БББББББ    Б
ББББББББББББББББББББББББББББББББББББББББББББББББББББББББББББББББББББББ