Spider Web
1
You are chased by the minotaur into the Arachnoid Web !
4 3 19 70
2 2 10 59 4
1 0 0 0 null
ЭЭЭЭЭЭЭЭЭЭЭЭЭЭЭЭЭЭЭЭЭЭЭЭЭЭЭЭЭЭЭЭЭЭЭЭЭЭЭЭЭЭЭЭЭЭЭЭЭЭЭЭЭЭЭЭЭЭЭЭЭЭЭЭЭЭЭЭЭЭЭ
ББББББББББББББББББББББББББББББББББББББББББББББББББББББББББББББББББББББ
Б  ББ                                                    Б           Б
ББ    БББББББББ БББ ББББББББ Б Б Б БББ ББББББББББББББ   БББ ББББББ
ББ ББ    ББ                 Б БББ Б   Б         ББББББББ ББ  БББББББ
Б  ББББ     ББББ Б ББББ Б Б  Б  БББ Б ББББ     ББ   ББББ Б     Б
БББ ББ ББББ   БББББ Б   ББ Б ББ Б ББ     БББББББББББ     ББ    Б ББ Б
Б      Б   Б    ББ БББ    Б  Б   БББББББББ           Б  ББ ББ Б БББ Б
БББ ББББ  ББББББ    БББББ ББ БББББ         БББББББ  ББ  Б БъБ Б
Б  БББ  БББ БББ ББ    Б Б  Б  Б    БББББББББББББББББББББ  БББ Б БъБ Б
БББ ББ  ББББ Б   БББББ     БББ   ББ    ББ    ББ    БББББББ     Б БББ Б
Б        БББ   БББ ББББББ     БББББББ    ББ    ББ    БББ  Б БББ ББ Б
Б БББ  Б   БББББ ББББ ББББ       ББББББББББББББББ     ББ  Б     Б
Б БББББ  Б БББББ            БББББ Б               ББББ ББББ БББББ Б Б
Б                 ББББББББББ    Б  ББББББББББББББ       ББББ Б    Б Б
ББББББББББББББ БББББ ББ ББ ББББ Б ББ               ББ Б      БББББ Б Б
Б                                   Б Б БББББББ БББ  Б ББ Б         Б
ББ Б ББББББББББББББББ БББББББББББ ББББ   Б Б Б Б БББ ББ ББ БББ ББ ББ Б
Б                                      Б                             Б
ББББББББББББББББББББББББББББББББББББББББББББББББББББББББББББББББББББББ
